Bizarrap - Shakira: Bzrp Music Sessions, Vol. 53
Moneybagg Yo & GloRilla - On Wat U On
Sam Smith - Gimme (feat. Koffee & Jessie Reyez)
Gracie Abrams - Where do we go now?
M83 - Oceans Niagara
PARTYNEXTDOOR - Her Old Friends
Gucci Mane - King Snipe
Måneskin - GOSSIP (feat. Tom Morello)
Paramore - C'est Comme Ça
Mimi Webb - Red Flags
Daughter - Be On Your Way
hemlocke springs - stranger danger!
Diplo - Wasted (feat. Kodak Black & Koe Wetzel)
TAEYANG - VIBE (feat. Jimin of BTS)
Offset - 2 LIVE
Vedo - Celebrate
ThxSoMch - CAROLINE
Ava Max - One Of Us
De La Soul - The Magic Number
SG Lewis - Fever Dreamer (feat. Charlotte Day Wilson & Channel Tres)
Vagabon - Carpenter
Armani White - GOATED. (feat. Denzel Curry)
Blanco Brown - I'll Never
Margo Price - Radio [Feat. Sharon Van Etten]
Ty Dolla $ign - 2022
Blessing Offor - Rollin'
Justin Quiles & Myke Towers - Whiskey y Coco
Jessie Murph - About You
Bea Miller - lonely bitch
Lukas Graham - Home Movies
Joesef - Moment
JAWNY - TRUE
Julia Wolf - Rookie of The Year
Quinn XCII - The Lows
Logic - Wake Up (feat. Lucy Rose)
Grupo Marca Registrada - El Pickles
The Chainsmokers - Make Me Feel
Chiiild - Good For Now (feat. Lucky Daye)
Belle and Sebastian - I Don't Know What You See In Me
Tommy Lefroy - Worst Case Kid
Chris Young - Looking for You
Stacey Ryan - Over Tonight
Ziggy Katz - Pieces of Gold
Ozuna - Quien Va a Frontiar
Luude - Oh My (feat. Moby)
Marshmello - Party Jumpin'
MONSTA X - Beautiful Liar
anees - free me
Daniel Seavey - I Tried
kenzie - paper
Ella Vos - Mindreader
Maria Becerra - DESAFIANDO EL DESTINO
Dierks Bentley - Same Ol' Me
Alana Springsteen - you don't deserve a country song
BUNT. - Clouds
Alok & James Arthur - Work With My Love
Aya Nakamura - Baby
03 Greedo - I Can't Control Myself (feat. OHGEESY)
Pouya - Seen It All Before
Lambo4oe - Tada
Kelz - Good 2 Me
Kamal. - essential
Babebee - sunset blvd
Freya Ridings - Weekends
JESSIA - Nobody Hates You
Old Dominion - Easier Said with Rum
Wilder Woods - Maestro (Tears Don't Lie)
All Time Low - Tell Me I'm Alive
Pierce The Veil - Even When I’m Not With You
JELEEL! - RIDE THE WAVE!
Bizzy Banks - Ok Ok Ok
Sam Feldt - Enough To Drink
Valley - Throwback Tears
Matt Hansen - LET EM GO
Nanna - Godzilla
Everything But The Girl - Nothing Left To Lose
Fuego - Luces
BabyTron - Beetleborgs
J.I the Prince of N.Y - It's Officially Done
Prentiss & skaiwater - so easily
Indy - Hometown
Ber - Your Internet Sucks
Abe Parker - Puppet On Your String
MAY-A - Sweat You Out My System
Andy Grammer - These Tears
Priscilla Block - Me Pt. 2
JANE HANDCOCK - Layin Next to Me
Liv.e - Find Out
Temples - Gamma Rays
Drayton Farley - Norfolk Blues
Royel Otis - I Wanna Dance With You
Rocco - l-o-v-e
Dreamer Isioma - Fuck Tha World
Farrah Hanna - Dog
Yandel - Te Gusta
Imanbek - Fake
21 Lil Harold - Ain't On None
Miss Grit - Lain (phone clone)