The Weeknd, Ariana Grande - Die For You - Remix
The Kid LAROI - I GUESS IT'S LOVE?
Don Toliver, Wizkid - Slow Motion (feat. Wizkid)
Gorillaz, Bad Bunny - Tormenta (feat. Bad Bunny)
Halsey - Die 4 Me
Chl√∂e & Chris Brown - How Does It Feel
Gracie Abrams - I know it won't work
Jonas Brothers - Wings
Yeat - Shmunk (feat. YoungBoy Never Broke Again)
MK & Dom Dolla - Rhyme Dust
Lil Wayne - Kant Nobody (feat. DMX & Swizz Beatz)
Quavo - Greatness
Skrillex, Yung Lean & Bladee - Ceremony
Rene√© Rapp - Bruises
Dierks Bentley - Walking Each Other Home
Dalex, Ryan Castro & Symon Dice - Perr–µ√°ndote
Logic - Lightsabers (feat. C Dot Castro)
Zack Bia - On–µ Of Those Days (feat. Lil Yachty & 347aidan)
Kali Uchis - Moonlight
mazie - are you feeling it now
JayO - 22
Jozzy - Alone
24kGoldn - Bite
Key Glock - Chromosomes
$uicideboy$ & Shakewell - SHAMELESS $UICIDE
Loud Luxury & DVBBS - Next To You (feat. Kane Brown)
Ashley McBryde - Light On In The Kitchen
Ingrid Andress - Treated Me Good
The National - New Order T-Shirt
Lola Young - Don't Hate Me
BoyWithUke - idtwcbf (friends)
Em Beihold - Roller Coasters Make Me Sad
quinnie - promised
CHVRCHES - Over
Nicky Youre - Shut Me Up
Maddie Zahm - STEP ON ME
Unknown Mortal Orchestra - Nadja
Luke Combs - Joe
The Band CAMINO - Told You So
Channel Tres - All My Friends
Rich The Kid - Do You Love Me? (feat. Lil Tjay)
EST Gee - Undefeated
ODESZA - Hopeful
Jayda G - Circle Back Around
Riovaz - Hypnotized (feat. skaiwater)
Imanbek, Trevor Daniel - In The Morning
Sueco - POS
Kembe X - Rolls Royce Top üêö
Russ - Gimme Love
Tink & Yung Bleu - Stingy
Tauren Wells - Halo - Spotify Singles
Nemahsis - i wanna be your right hand
Matilda Mann - The Day That I Met You
Meg Smith - All the Things You'd Ruin
Meet Me @ The Altar - Kool
Alex Porat - HATELOVE
U.S. Girls - Tux (Your Body Fills Me, Boo)
Dylan - Every Heart But Mine
RBD - S.H.E.A
Huddy - Slowly Healing
1nonly, Jasiah - GHOSTKILLA
G Herbo - Raining (feat. Yung Bleu & Murda Beatz)
Tiago PZK - Slow
Sada Baby, Lil Yachty - OLD SKOOL WHOOP üêö
Yaeji - Done (Let‚Äôs Get It)
Blusher - Dead End
Jason Isbell and the 400 Unit - Death Wish
Dreamville, Bas & Black Sherif - Blood, Sweat & Tears (feat. Kel-P) ‚òë
Finesse2tymes - Out of State
Blac Youngsta, 42 Dugg - I Don't üêö
Elderbrook, Vintage Culture - Talk It Over
Billy Lemos - COCKPIT (feat. spill tab, binki & Harve)
Blake Rose - Don't Stop the Car
Katy Nichole - Hold On
RAAHiiM - Outside Freestyle
Musiq Soulchild, Hit-Boy - beat of a slow dance
PRETTYMUCH - SAME PLACE
Sir Chloe - Hooves
Beauty School Dropout, jxdn - FREAK
Daniel Leggs - parasite
Phabo, Sha√© Universe - Out of Touch
Sam Fischer, Amy Shark - High On You
Kassi Ashton - Drive You Out Of My Mind
Allison Ponthier - Character Development
Militarie Gun - Do It Faster
Softcult - Love Song
Giant Rooks - Bedroom Exile
Monaleo - Ridgemont Baby
Kevin Ross - Show & Prove
G Perico, DJ Drama - Ask G4
DDG - Way Too Petty
Jidenna - Blush
Tobias Dray - You Made Me A Fool
V√âRIT√â - i thought i was waiting
Creams - Need to Talk
rum.gold - Water My Heart (feat. Mereba)
Bella White - Break My Heart
Conner Smith - Creek Will Rise