Lewis Capaldi - Haven't You Ever Been In Love Before?
Jimin - Angel Pt. 1 (feat. Jimin of BTS, JVKE, Muni Long, Kodak Black & NLE Choppa)
Summer Walker - New Type (feat. Childish Gambino)
KAYTRAMIN√â - Sossaup (feat. Amaarae)
Juice WRLD - No Good
Post Malone - Mourning
Kesha - Only Love Can Save Us Now
Conan Gray - Never Ending Song
Lana Del Rey - Say Yes To Heaven
Maroon 5 - Middle Ground
d4vd - Don't Forget About Me
Chappell Roan - Red Wine Supernova
Hozier - Francesca
Nicky Jam & Feid - 69
Morgan Wade - Psychopath
Foo Fighters - Under You
Ti√´sto & Mathame - Feel Your Ghost
H.E.R. - The Journey
Ella Langley - Could've Been Her
Briston Maroney - Body
PNAU, Bebe Rexha & Ozuna - Stars
Anne-Marie - UNHEALTHY (feat. Shania Twain)
NxWorries - Daydreaming
SoFaygo - Ye
$uicideboy$ - Provolone & Heroin (feat. Freddie Dredd)
SLANDER, blackbear & Bring Me The Horizon - Wish I Could Forget
Kelly Clarkson - favorite kind of high
Zara Larsson - End Of Time
Hannah Jadagu - Lose
The Japanese House - Sunshine Baby
Samara Joy - Sometimes Today Seems Like Yesterday
Rory, Ari Lennox & James Fauntleroy - My Phone Can Die
Jason Derulo - When Love Sucks (feat. Dido)
DDG - I'm Geekin (feat. Luh Tyler)
southstar - Typa Girl
Kanii,Riovaz,Nimstarr - Heart Racing
Nicki Nicole & Milo j - DISPARA ***
Blur - The Narcissist
LOVA - Popstar
ThxSoMch - Swap Places
Sleep Token - Rain
Mau P - Your Mind Is Dirty
The Dare - Sex
Kylie Minogue - Padam Padam
Katherine Li - I Just Wanna Know
Ray Laur√©l - U SAID!
Cavetown & Field Medic - Glacier Meadow
Sir Chloe - Should I
anees - sunny dayüêö
Belly - Cocaine Spoon (feat. Rick Ross)üêö
Tobe Nwigwe, Nas & Jacob Banks - On My Soul
Queen Naija - Words of Affirmation
Joeboy - Normally (feat. BNXN fka Buju & ODUMODUBLVCK)
ZHU - Revelations (feat. Devault & BabyJake)
Odetari - LOOK DON‚ÄôT TOUCH (feat. cade clair)
glaive - im nothing thats all i am
Kito - Cold Touch (feat. GrimesAI)
(G)I-DLE - Queencard
Liza Anne - Cheerleader
Ben Howard - Walking Backwards
Leith Ross - To Learn
Carin Leon & Camilo - Ni Me Debes Ni Te Debo
Elevation Worship - Jehovah (feat. Chris Brown)
Groupthink - Was I Supposed To Care?üêö
Jordyn Shellhart - Maybe Someday You‚Äôll Have A Daughter
shy martin - wait it out
Dylan Conrique - down from the high
Ama Lou - Caught Me Running
Genesis Owusu - Leaving The Light
Skillibeng - 16DEM
Sha Gz - Better Off Dead
The Used - Giving Up
Sofi Tukker & Sunnery James and Ryan Marciano - TROMPA‚òëÔ∏è
Fuerza Regida - TQM
Gregory Alan Isakov - The Fall
Jason Aldean - Try That In A Small Town
Brandy Clark - Dear Insecurity (feat. Brandi Carlile)
Kidd G - Daylight Savings
The Milk Carton Kids - I Only See the Moon
bar italia - changer
Chase Shakur - x's n o's üêö
Tora-i - 17suns
KennyHoopla - YOU NEEDED A HIT//
PGF Nuk - YEAH‚òëÔ∏è
Maeta - Through The Night (feat. Free Nationals)
Chxrry22 - Worlds Away
Johnny Dailey - Living Don't Cost a Lot
Homeschool - Hanger-onüêö
Lord Huron - Ace Up My Sleeve
BOYS LIKE GIRLS - BLOOD AND SUGAR
Dave Matthews Band - Walk Around the Moon
Horse Jumper of Love - Heartbreak Rules
Little Moon - wonder eyeüêö
Juanes & Juan Luis Guerra - Cecilia
Maple Glider - Don't Kiss Me
Oxlade,Flavour - OVAMI
SahBabii - Lost All My Feelings
Charlotte de Witte - Overdrive - Editüêö