Lil Baby - Go Hard
Q - SOW
Marshmello,Brent Faiyaz - Fell In Love
Bailey Zimmerman & Dermot Kennedy - Won‚Äôt Back Down (feat. YoungBoy Never Broke Again)
Megan Moroney - Traitor Joe
Gucci Mane - Pissy (feat. Roddy Ricch & Nardo Wick)
DaBaby - SHAKE SUMN
Benson Boone - Little Runaway
Anuel AA, DJ Luian & Mambo Kingz - Mejor Que Yo
LE SSERAFIM - UNFORGIVEN (feat. Nile Rodgers)
SleazyWorld - Off The Court (feat. Polo G & Einer Bankz)
$uicideboy$ - Realism VS Idealism
Bring Me The Horizon - LosT
grandson - Half My Heart
Luke Bryan - But I Got A Beer In My Hand
Ed Sheeran - End Of Youth
hemlocke springs - sever th–µ blight
Bruno Major - We Were N–µver Really Friends
laye - touching myself
Snakehips, Daya & EARTHGANG - Sometimes‚Ä¶
Gryffin & Kid Joi - Oceans
PHABO - Casamigos üêö
CKay - HALLELUJAH (feat. Blaqbonez)
Fireboy DML - Someone
OHGEESY - Games (feat. 03 Greedo & Bino Rideaux)
Armani White - PROUD OF ME. (feat. Fridayy)‚òëÔ∏è
Destroy Lonely - how u feel?
Peso Pluma, Eladio Carrion - 77
aespa - Welcome To MY World (feat. n√¶vis)
Icona Pop & Yaeger - Shit We Do For Love
Galantis & JVKE - Fool 4 U (feat. Enisa)
tobi lou & FARADA - Sorry I'm Late üêö
Eem Triplin - TELL ME IM RIGHT
Chencho Corleone - Un Cigarrillo
MisterWives - Nosebleeds
BETWEEN FRIENDS - Redlight (feat. Teezo Touchdown)
Chet Faker - Something Like This üêö
Durand Jones - See It Through üêö
KIRBY & Rapsody - Eve Gene
Sam Barber - Ghost Town
Lovejoy - The Perfect Pair - Spotify Singles
Natanael Cano - Pacas De Billetes
Connor Price & Hoodie Allen - Vroom
Flume & Jim-E Stack - Chalk 1.3.3 [2017 Export Wav]
Fred again.. & Brian Eno - Enough
Amaarae - Co-Star
BL√ú EYES - The Last Song
SBTRKT & LEILAH - NO INTENTION
C√©line Dion - I'll Be
Chandler Leighton - Fixer Upper
MacKenzie Porter - Chasing Tornadoes
Lecrae & Tasha Cobbs Leonard - Your Power
Russ - Fire
Saint Harison - james (bleeding alone)
Belly - Ambiance
JELEEL! - COME HERE!
DD Osama - Who I Am
Nippa - Maddest Hoes
kwes. - Open Up (feat. Sampha & Tirzah)
Alvaro Diaz - YOKO
Danielle Ponder - Roll The Credits
Jenna Raine - Crickets
Sadie Jean - Just Because
Claud - Every Fucking Time
Telescreens - Phone Booth
underscores - Cops and robbers
The Hives - Bogus Operandi
Alan Walker & Sasha Alex Sloan - Hero
salute - Feels Like My Hands Are On Fire
Omarion - Girls
IDK, Jucee Froot & Saucy Santana - Pinot Noir
Reggie Becton - Sadboy
Jidenna - MAYBE SWANKAFORNiA üêö
Fuerza Regida & Myke Towers - Pariente
Alan Palomo - Nudista Mundial '89(feat. Mac DeMarco)
Conway the Machine & Westside Gunn (Hall & Nash) - Brucifix
NoCap - Cuban Links
will.i.am & Lil Wayne - THE FORMULA
The Smashing Pumpkins - Fireflies
Mareux - Killer
Turnpike Troubadours - Mean Old Sun
Zoe Ko - Fire Escape
Kimberly Perry - If I Die Young Pt. 2
Bethany Cosentino - It‚Äôs Fine
Nanna - How to Start A Garden
Nathaniel Rateliff & The Night Sweats - Buy My Round
Kirk Franklin - All Things üêö
Ethan Tasch - Holdup
Meghan Patrick - Red Roses & Red Flags
Karley Scott Collins - Hands on the Wheel
Lava La Rue - Renegade
Panchiko - Gwen Everest
Sean Leon - BLOOD
Cisco Swank - No Funny (feat. Yoshi T.) üêö
Brandon - Timeüêö
Carter Faith - Wild
Logan Halstead - Dark Black Coal
Common Hymnal, Praise Paige & James Paek - Breaking Me Downüêö