Niall Horan - Meltdown
Coi Leray - Bops
Miguel - Give It To Me
Kesha - Eat The Acid
Thundercat - No More Lies
Jack Harlow - They Don't Love It
Bebe Rexha - Seasons
The National - The Alcott (feat. Taylor Swift)
Eslabon Armado - Quedate Conmigo
Diplo - Sad in the Summer (feat. Lily Rose)
ILLENIUM - Eyes Wide Shut
TAEYANG - Shoong! (feat. LISA of BLACKPINK)
Rema - Charm
Joy Oladokun - Somebody Like Me
Nate Smith - World on Fire
Nessa Barrett - american jesus
Beach House - Holiday House
Brenn! - 4Runner
Rich The Kid - Still Movin‚Äô (feat. Fivio Foreign & Jay Critch)
G Herbo - Outside
Jhayco - Mami Chula
DaniLeigh - Tasty
Stephen Sanchez - Only Girl
Jason Derulo - Glad U Came
Shouse - Live Without Love
SEVENTEEN - Super
ThxSoMch - Crumbled
Mora - R√ÅPIDO
The Aces - I've Loved You For So Long
Ryan Beatty - Bruises Off The Peach
glaive - as if
Kanii - Go (Xtayalive 2)
kenzie - sickly sweet
Amaria - Damaged
Jay Wheeler - Te La Dedico
Indigo De Souza - The Water
PJ Harvey - A Child's Question, August
Kip Moore - Sometimes She Stays
K.Flay - Raw Raw
Tee Grizzley - Striker Music
LUCKI - Leave Her
R3HAB - Rock My Body
Stonebwoy - Life & Money
Baby Rose - Dance With Me
JOSEPH - Fireworks
Sara Kays - Miss Me The Same (with Anson Seabra)
Valley - Break For You
Gigi Perez - Kill For You
Alana Springsteen - twenty something
Shania Twain - Bone Dry
Freya Ridings - I Feel Love
Jessie Ware - Freak Me Now
The Blessed Madonna - Fuck what u heardüïí
Slum Village - Just Like You
2Rare - Toxic Ishüïí
SEB - moving on (feat. Khary)
Harriette - i heart the internet
Knox - Love Letter
Movements - Lead Pipe
Rico Nasty - Turn It Up
Lola Brooke - Just Relax
Sonny Fodera - Like I Used To
Deb Never - Paper Houses
Bedroom - Weekday/Anythingüïí
Lauren Daigle - New
Margo Price - Hands On The Wheel (Feat. Particle Kid) (Recorded at Luck Reunion) - Spotify Singles
Colton Dixon - Canvas
Cole Swindell - Sad Ass Country Song
AnnenMayKantereit - Toxic
Teezo Touchdown - 5 O‚ÄôClock
Sam Truth - Rainbow Mind
Boj - Line Of Fire‚òëÔ∏è
grentperez - When The Day Is Done
Alice Phoebe Lou - Open My Door
Peach PRC - Kinda Famous
UPSAHL - GOOD GIRL ERA (SIDE A)
BKAYE - All In My Headüïí
Chromeo - Replacements (feat. La Roux)
Gloss Up - Check
Mad Tsai - in my head
ASTN - How Soon
quinnie - fade - flounder bonus track
Billy Strings - California Sober (feat. Willie Nelson)
Willie Jones - Something To Dance To
The Gaslight Anthem - Positive Charge
Matt Maltese - Widows
rum.gold - Forever In A Song
R-Mean - Yessir
Homixide Gang - 5!RE
Sam Wills - Don't Doubt Itüïí
Dennis Lloyd - Whatever It Takes
Deer Tick - Forgiving Ties
Warren Zeiders - Coming Down High
Danielle Bradbery - Monster
Zinadelphia - Cosmos
Kadeem Tyrell - Since You've Been Goneüïí
Creams - Almighty